#######################
#      #     #  #     #
# ##$ $ $ $.@ $   ### #
# #.. #..##.###..##.. #
# #* $.$.$ * $ * $.$. #
# $.$ * * $.$ $.$ * * #
# #* $.$.$ * $ * $.$. #
# #.$ * * $.$ $.$ * * #
# .* $.*.*#*.$.*#$.*.*#
#                     #
#######################
