#######################
#                     #
# ##################$##
# #...#            #  #
# #...# $$$$$$$$ # #  #
# #..$  $      $#. $  #
# #   #   $$$$$$.# #  #
# #...# # .....#   .###
# #################$  #
#@                    #
#######################
