    #####          
    #   #          
    #   #          
  ###  $##         
  #    $ #         
### # ## #   ######
#   # ## #####   .#
# $             ..#
##### ### #@##    #
    #     #########
    #######        
