#######################
#     #  #    #    #  #
# *$$   $$$#.$$$# $$$ #
# *.* #    #... #.  . #
# * $.# ...#. #.#. #. #
##* $.#.$$* .$$* .$$*##
# *.+ # ...#... # ... #
# $ $ # $$$# $$$#  #. #
# $$$ #  # #  # # **$ #
#     #    #    #  #  #
#######################