    #####          
    #   #          
    #   #          
  ###   ##         
  #  $   #         
### # ## #   ######
#   # ## #####  ..#
#               ..#
##### ### #@##  ..#
    #     #########
    #######        
