    #####          
    #   #          
    #   #          
  ###   ##         
  #  $   #         
### # ## #   ######
#   # ## #####    #
#                .#
##### ### #@##    #
    #     #########
    #######        
